_ e e c e _ c _ c c c _ _ _ _ _ c _ e _ c e _ _ e _ _ _ _ _ _ _ _ c c _ _ c _ _ _ _ e _ _ c _ c _ e _ _ _ c c _ c e c c e _ c _ _ _ e _ c _ _ e _ c _ _ c e c _ _ c e c e _ e c c _ _ _ e c _ _ _ _ e c e c _ _ c _ _ _ c _ c e _ e c c c _ _ e _ _ c _ _ e c _ c _ _ _ _ c _ e _ _ c _ e e e _ c e c c _ _ _ c c _ _ e _ c e _ _ _ _ _ e _ c _ _ c c _ e _ _ c _ _ _ c _ c c c _ c _ _ _ _ c _ e _ _ e _ _ _ _ _ e _ _ c e _ e _ _ _ _ e _ _ c _ c _ _ _ _ c c c _ c e e _ c _ c _ e e _ _ c e _ c c _ _ c c e c c _ _ _ c e _ _ e e c _ e _ c _ _ _ e _ _ c c _ c _ c _ _ _ c _ _ e _ c _ e _ c _ _ c e _ _ _ _ c _ e 
c e e _ _ c e _ _ e _ _ c c _ _ _ c _ _ c c _ c _ c _ c _ c c e _ e c c c e e c _ _ e c _ _ _ _ _ e _ c c _ _ c e c c c _ _ e c e _ e c _ e c _ e _ c c _ _ c e c _ _ _ e _ _ e e c _ _ c e c e _ c _ _ c _ _ _ _ e _ _ e c c _ e e _ _ e e c _ c _ e _ _ _ c _ _ _ _ _ c c _ _ e _ _ c e c c _ _ _ _ c c _ _ _ c c c c _ _ _ e _ _ _ c c c c _ _ _ c _ c e c c c c _ _ _ c _ _ e _ c _ _ _ _ c e c _ _ _ c _ e e _ c _ c _ e _ c c _ _ _ _ _ _ c e c e c c c c _ _ e _ _ _ c _ _ _ e c e e c c e e _ _ _ _ _ _ _ e _ _ c _ e _ e _ c e _ _ _ e _ e _ _ _ c c _ _ _ _ _ e _ _ _ _ _ e c _ _ _ c _ c _ _ _ c c c c c c e 
_ c e e _ _ _ c _ c c _ _ c c _ c c _ e c e _ _ _ c e c _ _ e c e c _ _ _ c c _ _ _ c c _ _ _ c _ c _ _ c _ c c _ _ _ e c e c _ e _ _ _ _ _ e _ e _ _ _ _ _ c c _ _ e c _ _ e _ e c e _ e c _ e _ c _ c c _ _ c c c e _ _ c _ _ _ _ c _ c _ c _ _ _ _ _ _ _ c _ c c c _ _ _ c _ c c e _ _ c _ c c e _ c _ _ _ _ _ _ _ _ _ c e _ c _ _ _ _ e _ _ e c e _ c c _ c c _ c _ c e c c _ e c _ c _ _ c c _ _ _ _ _ c _ _ _ _ _ _ _ _ _ _ c e _ _ _ c c c c _ _ e _ _ _ _ _ c c _ _ c _ _ c _ _ _ _ e _ _ _ c _ e _ c _ _ _ e c c c c c e _ _ _ e c c _ _ e _ e e c c _ _ _ c _ _ c _ _ _ c _ e _ _ _ _ _ _ _ c e _ e e c c e e 
_ _ e _ c c c _ c e _ e c _ c _ _ _ c e c _ c _ c c c e _ _ e _ _ _ _ c c c c c c c e c c _ e c c c _ e e c c c _ c c _ _ e c c c _ _ _ _ c c _ c c c c c _ _ c c _ _ e _ c _ c c _ c e _ c c c c _ _ _ c _ _ _ _ _ c c _ c e c _ c c e e e _ c _ _ _ e e c e _ e e _ _ c e e e c e _ _ e e e c c e _ _ e _ _ _ e _ c _ c c e c _ c _ _ _ c _ e _ _ c c _ e _ c _ _ _ _ _ c _ _ c c _ _ c _ _ _ _ _ e e e c _ e _ e c c c c c e e _ _ e _ _ c _ _ c _ c c _ _ _ e _ e c _ e c c _ _ e e e c _ _ c _ e e _ _ c _ _ c c c e _ _ _ e _ e c c _ c c _ _ _ c c e e c _ _ c _ c _ _ c c e c _ _ e _ _ c c c e _ c c _ _ _ c _ 
e _ _ e _ _ c _ _ c _ _ e _ _ e _ c _ c _ _ _ _ _ e e _ c e c _ _ e e e _ _ e e c _ _ _ c e _ c _ _ c _ e _ e _ c c c _ c _ e e e _ e _ c e c _ _ _ e e _ e e c _ e _ _ _ c _ _ e e c c e e _ _ _ c _ e e c c e _ e c _ e _ _ e c _ c _ c _ c c c c _ _ _ _ c c c e c e _ _ _ _ _ _ _ e c _ e c _ _ c c _ e c _ e _ c _ c c c c _ c c c _ _ _ _ _ c _ _ c _ c _ e _ e _ e e _ _ _ e c c e c _ _ _ _ c e c c c c c _ c e c _ _ _ e _ c _ c c e _ c _ e _ e _ c e e _ _ _ e _ _ _ _ _ e c e c c _ c e e _ _ c e _ e _ _ _ e _ e _ _ _ c _ c c e c _ _ _ _ _ _ _ _ c e _ _ _ _ c e _ e _ _ c _ c c c e _ _ _ _ c e c _ e c 
e c c e _ c c _ c c e e c e _ _ _ c e _ _ _ c e e _ c _ _ e c _ c _ c e _ c c _ e _ c c _ _ _ _ c c e _ e e c _ e _ e e e c _ _ _ _ _ e e c c c c c _ _ c c _ _ _ _ _ _ _ c c c c e c e _ _ _ _ _ _ _ c _ _ _ c _ e _ c e _ c c _ c c c c _ c _ c c c _ _ c _ c _ c _ c e c _ c _ c c _ _ _ _ _ e c e _ c _ _ e c c c c c _ _ _ c _ _ _ c c _ c _ _ e e c c _ e e e _ _ c e _ _ c c c _ c c c _ _ _ c _ c c _ _ e _ e _ c e c _ _ _ _ c c e _ _ e e _ c e c _ c c _ _ _ _ _ c _ e e c _ e c e c c _ c c _ _ c _ _ _ e e c e c _ e _ e _ c c _ _ e c c c c c _ c c c _ _ e _ e _ _ c e _ _ _ _ _ e _ c c e e c _ c c _ e 
c _ c _ _ _ e _ _ c _ c _ c c _ c _ e e c _ _ _ c c _ c _ _ _ c c _ e c _ e c c _ _ c _ e e _ _ e e _ e _ c c _ c c e c c _ _ _ e c _ c _ c c _ _ _ c _ _ e c e _ _ _ c _ e _ _ c c c _ _ _ e c e c _ _ e _ c _ c c e c _ _ e c _ c _ _ e e _ c c _ c c e _ e c e c _ _ e _ _ _ _ _ c e _ _ e e e c _ c _ c _ _ c c c c e _ _ e c e _ _ _ c _ _ c c c _ c _ e _ _ _ c _ c c _ c c _ e e _ c e e _ c _ _ _ c _ c _ e e c c c _ _ _ c _ c c e _ c _ _ c _ _ c c e _ c c _ _ c _ c e c _ _ c _ _ _ c e _ e e _ e e c c _ _ c _ c _ c _ _ e c _ _ _ _ c _ e e c _ _ _ _ _ c c e _ e e e _ _ _ _ _ e _ c c _ c c _ e _ _ c c 
c _ c e c e _ c _ c c _ _ c _ _ _ _ c e c _ e c _ _ e _ _ c _ e c _ _ c _ _ c e _ c _ _ c _ _ _ _ e c _ c c c _ _ e e c _ _ _ _ _ e _ _ _ c _ _ c e e c _ _ _ _ e _ _ e _ _ e c e e e c _ _ e c e e _ e _ e _ e c _ _ e e _ e _ _ e _ e _ _ e _ _ _ _ _ _ c _ c c _ _ e _ c c c e e _ c c _ e _ _ _ c c _ c _ _ c _ _ _ _ _ c _ c _ _ c c _ _ c c c e _ _ c _ c e e _ c _ _ e c _ e e c c _ _ _ c e e _ c _ _ e _ _ _ _ _ _ e _ _ e e e e e _ e _ c c _ _ _ c c c c c c c _ e _ c _ e c _ _ c c e c _ e _ c _ _ _ _ e _ _ c c e _ c _ c c _ _ c _ _ _ e c _ _ e e c e c e c _ c _ e c c c _ c _ c c e e c e c c c e _ _ 
_ _ e _ _ _ _ _ _ c _ c _ _ c e _ c _ e _ c _ c _ e e c c e e c e _ _ c c _ c c c _ e _ c _ _ c _ _ _ c _ c c _ _ _ c e c _ c e e e _ _ _ _ c _ _ e _ _ e _ e c _ c _ c e c _ c c c _ c e _ _ _ c _ c c c _ c _ c _ c _ c _ c e _ _ c _ _ _ c e _ c c _ c _ c e c _ c _ e _ _ c c _ _ _ e c e _ c _ e _ _ _ e _ _ c e _ _ _ c c e _ _ e c c c e c c _ e _ _ e c c _ e c _ _ c _ c _ _ _ _ c c _ c c c _ e _ c _ e c c _ c c c _ _ c c c _ _ e c _ _ _ _ c c c _ e c _ c c e e e c _ _ _ e e _ _ _ e _ e c e _ e _ e e e _ e e _ c c _ _ c _ c c e e c c _ _ _ _ _ c _ _ _ _ c c _ _ e _ e _ c c _ c e _ c e _ _ _ e _ c 
c _ _ c _ _ _ c c c _ c _ c _ _ e _ _ c c _ _ c _ _ c e _ c _ e _ c _ c c c _ _ _ c c c c e c e _ _ c e e _ c c c _ c c _ _ c _ _ e c _ _ _ _ _ _ _ e c _ e e c c _ _ c _ c c c c _ c _ c _ c c _ e c c _ c _ c e _ c c c c e _ c e e e c c _ c c _ _ e _ _ _ _ _ c _ c c _ c _ c _ c c e c _ e c _ _ e _ _ e _ _ _ c e c _ c c e _ _ c e _ _ c _ e c _ _ e c _ c c e c _ e c c _ c e _ _ _ c _ e _ _ e _ _ _ e c _ e _ c _ _ _ c _ e _ c _ e _ c c e _ _ _ c _ c _ c c _ c _ _ _ _ e c _ _ _ _ _ e _ _ c e _ c _ c c _ c _ c _ _ _ c _ c _ c c e _ _ c c c _ c e c _ _ _ c e _ c _ _ c _ _ _ _ e _ _ _ c e c c e _ c e 
